*运输服务*客运服务费,成都滴滴优行科技有限公司,免税	道路旅客运输服务	道路旅客运输服务
*运输服务*客运服务费,成都滴滴优行科技有限公司,3%	道路旅客运输服务	道路旅客运输服务
*电信服务*通信服务费,中国联合网络通信有限公司天津市分公司,0	基础电信服务	基础电信服务
*运输服务*客运服务费,苏州市吉利优行电子科技有限公司,3%	道路旅客运输服务	道路旅客运输服务
*电信服务*通信服务费,中国电信股份有限公司上海分公司,*	基础电信服务	基础电信服务
*运输服务*客运服务费$__$*运输服务*客运服务费,滴滴出行科技有限公司,3%	道路旅客运输服务	交通运输服务
*运输服务*客运服务费*运输服务*客运服务费,江西滴滴出行科技有限公司上饶分公司,33	交通运输服务	交通运输服务
*电信服务*通信服务费,中国联合网络通信有限公司上海市分公司,0	基础电信服务	基础电信服务
*乙醇汽油*95号车用乙醇汽油（E10）（VIB）,中国石化销售股份有限公司河北沧州泊头石油分公司,13%	汽油	汽油
*乙醇汽油*95号 车用乙醇汽油（E10）（VIB）,中国石油天然气股份有限公司河北沧州销售分公司第九加油站,13%	汽油	汽油
*住宿服务*住宿,昆明市雅郡酒店管理有限责任公司,6%	住宿服务	住宿服务
*运输服务*客运服务费,上海滴滴畅行科技有限公司,3%	道路旅客运输服务	道路旅客运输服务
*电信服务*通信服务费*电信服务*销售折扣,中国移动通信集团四川有限公司天府新区分公司,免税免税	基础电信服务	基础电信服务
*住宿服务*住宿费,陕西阳光租赁服务有限责任公司,6	住宿服务	住宿服务
*运输服务*客运服务费$__$*运输服务*客运服务费,福州滴滴畅行科技有限公司,3%	交通运输服务	交通运输服务
*电信服务*通信服务费,中国移动通信集团四川有限公司成都分公司,*	基础电信服务	基础电信服务
*餐饮服务*餐费,石家庄星胡餐饮服务有限公司,1%	餐饮服务	餐饮服务
*住宿服务*住宿费,沈阳鹏程伟业酒店管理有限公司,1	住宿服务	住宿服务
*电信服务*通信服务费,中国电信股份有限公司上海分公司,0	基础电信服务	基础电信服务
*运输服务*客运服务费$__$*运输服务*客运服务费,江西滴滴出行科技有限公司,3%	道路旅客运输服务	交通运输服务
*电信服务*通信服务费,中国电信股份有限公司上海分公司,*	基础电信服务	基础电信服务
*乙醇汽油*95号车用乙醇汽油（E10）（VIB）,中国石化销售股份有限公司河北沧州石油分公司,13%	汽油	汽油
*电信服务*通信服务费,中国联合网络通信有限公司上海市分公司,0	基础电信服务	基础电信服务
*住宿服务*住宿费,辽宁铂丰酒店管理有限公司,1	住宿服务	住宿服务
*运输服务*客运服务费*运输服务*客运服务费*运输服务*客运服务费*运输服务*客运服务费,北京滴滴出行科技有限公司,免税免税33	交通运输服务	交通运输服务
*运输服务*客运服务费,成都滴滴优行科技有限公司,免税	道路旅客运输服务	道路旅客运输服务
*乙醇汽油*92号车用乙醇汽油（E10）（VIB）,中国石化销售股份有限公司河北沧州泊头石油分公司,13%	汽油	汽油
*电信服务*电信业务使用费,中国电信股份有限公司成都分公司,*	基础电信服务	基础电信服务
*餐饮服务*餐饮费,中旅（咸阳）海泉湾有限公司,6	餐饮服务	餐饮服务
*住宿服务*住宿服务,曲靖高朋酒店管理有限公司,6	住宿服务	住宿服务
*运输服务*客运服务费,滴滴出行科技有限公司,3	道路旅客运输服务	道路旅客运输服务
*运输服务*客运服务费,江西省江南出行运输服务有限公司,3%	道路旅客运输服务	道路旅客运输服务
*电信服务*电信业务使用费,中国电信股份有限公司成都分公司,0	基础电信服务	基础电信服务
*电信服务*通信服务费,中国移动通信集团四川有限公司天府新区分公司,免税	基础电信服务	基础电信服务
*乙醇汽油*95号车用乙醇汽油（E10）（VIB）,中国石化销售股份有限公司河南郑州石油分公司,13%	汽油	汽油
*电信服务*通信服务费*电信服务*销售折扣,中国移动通信集团四川有限公司成都分公司,免税免税	基础电信服务	基础电信服务
*运输服务*客运服务费*运输服务*客运服务费,滴滴出行科技有限公司,33	交通运输服务	交通运输服务
*住宿服务*住宿费,大连市西岗区四季冠庭旅馆,6	住宿服务	住宿服务
*餐饮服务*餐饮服务,西安塔峪餐饮有限公司,1	餐饮服务	餐饮服务
*汽油*汽油,西安市龙首加油站,13%	汽油	汽油
*运输服务*客运服务费,杭州携华网络科技有限公司芜湖分公司,3%	道路旅客运输服务	道路旅客运输服务
*住宿服务*住宿费,南昌市欢朋酒店管理有限公司,1%	住宿服务	住宿服务
*乙醇汽油*95号车用乙醇汽油（E10）（VIB）,中国石化销售股份有限公司河北沧州石油分公司,13%	汽油	汽油
*运输服务*客运服务费,广西滴滴出行科技有限公司,3	道路旅客运输服务	道路旅客运输服务
*运输服务*客运服务费,杭州携华网络科技有限公司芜湖分公司,3%	道路旅客运输服务	道路旅客运输服务
*乙醇汽油*92号车用乙醇汽油(E10)(ⅥA),中国石化销售股份有限公司安徽合肥石油分公司,13	汽油	汽油
*餐饮服务*餐饮服务,海安江南厨房餐厅,3%	餐饮服务	餐饮服务
*运输服务*客运服务费,滴滴出行科技有限公司,3	道路旅客运输服务	道路旅客运输服务
*运输服务*客运服务费,江西滴滴出行科技有限公司,3%	道路旅客运输服务	道路旅客运输服务
*电信服务*通信服务费$__$*电信服务*销售折扣,中国移动通信集团四川有限公司德阳分公司,:	基础电信服务	基础电信服务
*运输服务*客运服务费$__$*运输服务*客运服务费,北京滴滴出行科技有限公司,3%	道路旅客运输服务	交通运输服务
*住宿服务*住宿费,西安雀笙酒店管理有限公司,6%	住宿服务	住宿服务
*住宿服务*住宿费,大连市西岗区四季冠庭旅馆,6	住宿服务	住宿服务
*运输服务*客运服务费,滴滴出行科技有限公司,3	道路旅客运输服务	道路旅客运输服务
*乙醇汽油*95号车用乙醇汽油(E10)( VIB),中国石化销售股份有限公司河北沧州石油分公司,13	汽油	汽油
*运输服务*客运服务费$__$*运输服务*客运服务费,辽宁滴滴出行科技有限公司,免税	交通运输服务	交通运输服务
*住宿服务*住宿服务,成都市盛星酒店管理有限公司,6	住宿服务	住宿服务
*电信服务*通信服务费,中国移动通信集团四川有限公司德阳分公司,*	基础电信服务	基础电信服务
*电信服务*通信服务费,中国移动通信集团山东有限公司济南分公司,0	基础电信服务	基础电信服务
*乙醇汽油*95号车用乙醇汽油（E10）（VIB）,河北高速燕赵驿行集团有限公司辛集服务区,13	汽油	汽油
*住宿服务*住宿费,沈阳市和平区瑞麟酒店,6	住宿服务	住宿服务
*运输服务*客运服务费*运输服务*客运服务费,北京滴滴出行科技有限公司,33	交通运输服务	交通运输服务
*电信服务*通信服务费,中国电信股份有限公司上海分公司,0	基础电信服务	基础电信服务
*住宿服务*住宿费,云南铭朵酒店管理有限公司,6%	住宿服务	住宿服务
*运输服务*客运服务费,杭州携华网络科技有限公司芜湖分公司,3%	道路旅客运输服务	道路旅客运输服务
*住宿服务*住宿服务,吉林市吉林经济技术开发区鑫海如家酒店,3	住宿服务	住宿服务
*餐饮服务*餐费$__$*餐饮服务*餐费,简阳市海捞餐饮管理有限公司西安市锦业路分公司,6%	餐饮服务	餐饮服务
*电信服务*通信服务费,中国移动通信集团四川有限公司德阳分公司,*	基础电信服务	基础电信服务
*电信服务*通信服务费,中国移动通信集团四川有限公司天府新区分公司,免税	基础电信服务	基础电信服务
*运输服务*客运服务费$__$*运输服务*客运服务费,福州滴滴畅行科技有限公司,3%	交通运输服务	交通运输服务
*运输服务*客运服务费,上海赛可出行科技服务有限公司,3%	道路旅客运输服务	道路旅客运输服务
*住宿服务*住宿费,曲靖锦明春禾酒店管理有限公司,1%	住宿服务	住宿服务
*电信服务*电信业务使用费,中国电信股份有限公司成都分公司,*	基础电信服务	基础电信服务
*餐饮服务*餐饮服务,陕西胜程餐饮管理有限公司,6%	餐饮服务	餐饮服务
*电信服务*通信服务费,中国移动通信集团四川有限公司成都分公司,免税	基础电信服务	基础电信服务
*运输服务*客运服务费,广西滴滴出行科技有限公司,3%	道路旅客运输服务	道路旅客运输服务
*电信服务*通信服务费,中国移动通信集团上海有限公司,*	基础电信服务	基础电信服务
*电信服务*通信服务费,中国移动通信集团四川有限公司成都分公司,*	基础电信服务	基础电信服务
*运输服务*客运服务费$__$*运输服务*客运服务费,南京滴滴出行科技有限公司,3%	道路旅客运输服务	交通运输服务
*汽油*95号车用汽油（ⅥB）,中国石化销售股份有限公司湖南岳阳石油分公司,13	汽油	汽油
*电信服务*通信服务费,中国联合网络通信有限公司成都市分公司,0	基础电信服务	基础电信服务
*电信服务*通信服务费,中国电信股份有限公司上海分公司,0	基础电信服务	基础电信服务
*餐饮服务*餐饮服务费,西安曲江新区宝名餐饮店,免税	餐饮服务	餐饮服务
*餐饮服务*餐饮服务费,西安曲江新区宝名餐饮店,免税	餐饮服务	餐饮服务
*餐饮服务*餐费,西安市长安区都江石锅鱼庄,免税	餐饮服务	餐饮服务
*住宿服务*住宿费,西宁城东区桔子树宾馆,1	住宿服务	住宿服务
*运输服务*客运服务费,上海滴滴畅行科技有限公司,3	道路旅客运输服务	道路旅客运输服务
*餐饮服务*餐费,管氏餐饮（北京）有限公司上地店,6	餐饮服务	餐饮服务
*电信服务*通信服务费,中国联合网络通信有限公司朝阳市分公司,0	基础电信服务	基础电信服务
*住宿服务*住宿费,北京泽木森酒店管理有限公司,6%	住宿服务	住宿服务
